..............
....OOOOOOOO..
...O...O.X..O.
..O....O..X.O.
.O.........OO.
.O..........O.
.O..........O.
..OOOOOOOX..O.
.........OOO..
..............
 
00000000000000
00000000000000
00000000000000
000000#0#00000
0000000#000000
00000000000000
00000000000000
00000000000000
00000000000000
00000000000000
