................
....OOOOOOOO....
...O...O.X..O...
..O....O..X.O...
.O.........OO...
.O..........O...
.O..........O...
..OO...OOX..O...
.........OOO....
..OO............
................
 
0000000000000000
0000000000000000
0000000000000000
000000#0#0000000
0000000#00000000
0000000000000000
0000000000000000
0000000000000000
0000000000000000
0000000000000000
0000000000000000
 
